################################
#..............@...............#
#..............................#
#..............................#
#..............................#
#..............................#
########.......................#
#...................#.....1....#
#...................#..........#
#...................#..........#
#...................#..........#
#...................############
#..............................#
#..............................#
#..............................#
#############....###############
            #....#
            #....#
            #....#
            #....#
#############....###############
#..............................#
#..............................#
#..............................#
#..............................#
#..............................#
########.......................#
#...................#..........#
#...................#..........#
#...................#..........#
#...................#..........#
#...................############
#..............................#
#..............................#
#..............................#
################################